11111111111111111111111111101
10040000101110101000011004001
10101110100000101011011011101
10100000001110100000011000001
10101111101110101111000011101
10000000000000100000011000001
11110111111111101011000011111
11110001000010001011011011111
11110101111010201011000011111
000001000000133g1011011000000
11110101111013331000000111111
11110101111010111111110111111
11110000000010111111110111111
10000111111000000000000100001
10111111111011101111110101101
10100000000000101000110101101
10101111110110101010110100001
10140000000110101010110141101
1000110011000p100010000001101
11111111111111111111111111101

0 ball
1 wall
2 gate          (only one)
p pacman        (only one)
g ghost         (only four)
3 blank
4 power ball

